11111111111111111111111111
10000000100000000100000001
10000000100000000100000001
11100111100111100111100111
00100100100100100100100100
00100100100100100100100100
00100100100100100100100100
11111100111100111100111111
00100100100000000100100100
00100100100000000100100100
00100111111111111111100100
00100000100000000100000100
00100000100000000100000100
11111111100000000111111111
10000000100000000100000001
10000000100000000100000001
10011111111111111111111001
10010000000100100000001001
10010000000100100000001001
11111110011100111001111111
10000010010000001001000001
10000010010000001001000001
10011111111111111111111001
10010010010000001001001001
10010010010000001001001001
11110010011100111001001111
10000010000100100001000001
10000010000100100001000001
11111111111100111111111111